#########
#       #
#   ##  #
#       #
##      #
#       #
#  P    #
#########
